11111111111111111111111111111111111111111
11111111111111111111111111111111111111111
11111111111111111111111111111111111111111
11111111111111111111111111111666666611111
11111100060000055433333111111655444611111
11111100000006005543333111111655444611111
11111100600600060554333000000055444611111
11111100000000000055444111111655444611111
11111100000000000605555111111655444611111
11111100000060000000555111111666666611111
11111100000000000000000111111111101111111
11111100000000000000000111111111101111111
11111100600600002000000111111111101111111
11111100000000022200000111111111101111111
11111100600000000006000111111111101111111
11111100006000220000000111111111101111111
11111100000002222200020111111111101111111
11111100000002222000020111111111101111111
11111100006000060000000111111111101111111
11111100000000000006000111111111101111111
11111111111110001111111111111111101111111
11111111111110001111111111111111101111111
11111111111110001111111111111111101111111
11111111111110001111111111111111101111111
11111100000200000200000111111111101111111
11111100000200000222220111111111101111111
11111100000202220000000000000000001111111
11111122000002020000006111111111111111111
11111122222000000006444111111111111111111
11111100000000000064444111111111111111111
11111111111111111111111111111111111111111
11111111111111111111111111111111111111111
11111111111111111111111111111111111111111
11111111111111111111111111111111111111111